00000000000000000000000000000000000000000000000000000000000000000000
00000000000000000000000000000000000000000000000000000000000000000000
0____________________________________________________000000000______
0__________________________0000_____________________________________
0_______________00______0____________________1______________________
0_______________00______0___________________00000___________________
0___________________________________________0___0___________________
0_________________________________________00_____00_________________
0_____________________________000________0_____1___0________________
0_______________________________________0____000____0_______________
0____________________CC___00___________0______0______0______________
0______CC_____________________________0_____00000_____0_____________
0______________________1_____2_______0_______000_______0___________D
0__X___00____4__00__000000___3______0_________0_________0_____D___00
00000000000000000000000000000000000000000000000000000000000000000000
00000000000000000000000000000000000000000000000000000000000000000000
