000000000000000000000000000000000000000000000000000000000000000000000000000000000000000000000000000000000000000000000000000000000000000000000000000000000000000000000000000000000000000000000000000000000000000000000000000000000000000000000000000000000000000000
000000000000000000000000000000000000000000000000000000000000000000000000000000000000000000000000000000000000000000000000000000000000000000000000000000000000000000000000000000000000000000000000000000000000000000000000000000000000000000000000000000000000000000
00000000_______________00_____00000______________________________C_________C___________________________________________________________________________________________________________________________________00_________________________________________________
0000000______C_________00_______________________________________000_______000___________________________________________________________________________________C___CCC______________________________________0_00_0_______________________________________________
000000______000________00________________________________CC______0_________0_________________________________________________________CC_________________________C__C___C______________________________00000___0__0________________________________________________
00000__________________00________________________________________0_________0_______________________C____________________________________________________________C__C___C________________________1_____________0000________________________________________________
0000__________________________________________C____00_00_________0_________0_______________________C____________________________________________________________C__C___C___________________0__0000____________0__0________________________________________________
000______________CC_______________________________0_____0_______________________________________________________________CC________00____________________________C__C___C_______________C__00__0000_C__________0__0________________________________________________
00_____________________________________000_______0_0___0_0_______________________________CC_______000_________________________________________1_________________C___CCC__________________000__0000_C__________0000________________________________________________
0__________CCC______________C__C________________0___0_0___0________________________________________________________________CCC____________0000000___________________________________C____000__0000_C______________________________________________________________
0_________00000______________1_________________0_C___1___C_0______________CC_______________00000___________________________00000_____________________00000_____________________________0_000__0000_C______________________________________________________________
0_________________________0000000_____________0____00000____0_________________________________________________________________________1________________________________2______________00_000__0000_C_______2______________________________________________________
0____________________________________________0__C___000___C__0______0___0_______________2_______________2_________0000000___________0000_______________________2_______3_____________000_000__0000______2__3_____2________________________________________________
0__X___00____1_____1_____0000__________1____0___1____0___1____0__1__0___0___1_____2__1__3_______1_______3___1__________________________________________________3___1___3___2___1____0000_000__0000___1__3__3__1__3___2____________________D______D________________
000000000000000000000000000000000000000000000000000000000000000000000___0000000000000000000000000000000000000000____________________________________________0000000000000000000000000000_000__00000000000000000000000000000000000000000000000000000000000000000000
000000000000000000000000000000000000000000000000000000000000000000000___0000000000000000000000000000000000000000____________________________________________0000000000000000000000000000_000__00000000000000000000000000000000000000000000000000000000000000000000
